Algorithm,Dataset,Iteration,Number Of Items,Best Value,Optimal Value,Shortfall,Operations,Time (Milli)
Simulated Annealing,f10_l-d_kp_20_879,1,20,1002,1025,23,120128,77
Simulated Annealing,f1_l-d_kp_10_269,1,10,151,295,144,60013,50
Simulated Annealing,f2_l-d_kp_20_878,1,20,901,1024,123,120075,81
Simulated Annealing,f3_l-d_kp_4_20,1,4,37,35,-2,24009,38
Simulated Annealing,f4_l-d_kp_4_11,1,4,22,23,1,24005,31
Simulated Annealing,f6_l-d_kp_10_60,1,10,56,52,-4,60011,46
Simulated Annealing,f7_l-d_kp_7_50,1,7,107,107,0,42007,37
Simulated Annealing,f8_l-d_kp_23_10000,1,23,9583,9767,184,138023,74
Simulated Annealing,f9_l-d_kp_5_80,1,5,142,130,-12,30008,36
Simulated Annealing,knapPI_1_10000_1000_1,1,10000,1548425,563647,-984778,63947060,19132
Simulated Annealing,knapPI_1_1000_1000_1,1,1000,6089,54503,48414,6218365,1215
Simulated Annealing,knapPI_1_100_1000_1,1,100,318,9147,8829,602813,119
Simulated Annealing,knapPI_1_2000_1000_1,1,2000,9311,110625,101314,12910735,2747
Simulated Annealing,knapPI_1_200_1000_1,1,200,119,11238,11119,1209823,196
Simulated Annealing,knapPI_1_5000_1000_1,1,5000,255455,276457,21002,33968862,8885
Simulated Annealing,knapPI_1_500_1000_1,1,500,2256,28857,26601,3061977,543
Simulated Annealing,knapPI_2_10000_1000_1,1,10000,1504213,90204,-1414009,63980792,19822
Simulated Annealing,knapPI_2_1000_1000_1,1,1000,4864,9052,4188,6255258,1616
Simulated Annealing,knapPI_2_100_1000_1,1,100,1347,1514,167,602237,196
Simulated Annealing,knapPI_2_2000_1000_1,1,2000,10179,18051,7872,13012959,3131
Simulated Annealing,knapPI_2_200_1000_1,1,200,1426,1634,208,1211635,417
Simulated Annealing,knapPI_2_5000_1000_1,1,5000,206669,44356,-162313,34168079,7983
Simulated Annealing,knapPI_2_500_1000_1,1,500,2169,4566,2397,3065254,681
Simulated Annealing,knapPI_3_10000_1000_1,1,10000,1781687,146919,-1634768,64081045,18308
Simulated Annealing,knapPI_3_1000_1000_1,1,1000,5911,14390,8479,6236740,1237
Simulated Annealing,knapPI_3_100_1000_1,1,100,1359,2397,1038,602719,113
Simulated Annealing,knapPI_3_2000_1000_1,1,2000,11519,28919,17400,12934172,2813
Simulated Annealing,knapPI_3_200_1000_1,1,200,1529,2697,1168,1210650,205
Simulated Annealing,knapPI_3_5000_1000_1,1,5000,312525,72505,-240020,33970305,8511
Simulated Annealing,knapPI_3_500_1000_1,1,500,3195,7117,3922,3062597,576
Simulated Annealing,f10_l-d_kp_20_879,1,20,882,1025,143,120032,78
Simulated Annealing,f1_l-d_kp_10_269,1,10,241,295,54,60013,59
Simulated Annealing,f2_l-d_kp_20_878,1,20,801,1024,223,120039,81
Simulated Annealing,f3_l-d_kp_4_20,1,4,28,35,7,24008,37
Simulated Annealing,f4_l-d_kp_4_11,1,4,22,23,1,24006,31
Simulated Annealing,f6_l-d_kp_10_60,1,10,37,52,15,60011,43
Simulated Annealing,f7_l-d_kp_7_50,1,7,139,107,-32,42007,39
Simulated Annealing,f8_l-d_kp_23_10000,1,23,10722,9767,-955,138025,82
Simulated Annealing,f9_l-d_kp_5_80,1,5,142,130,-12,30007,35
Simulated Annealing,f10_l-d_kp_20_879,1,20,861,1025,164,120053,67
Simulated Annealing,f1_l-d_kp_10_269,1,10,259,295,36,60010,38
Simulated Annealing,f2_l-d_kp_20_878,1,20,911,1024,113,120029,101
Simulated Annealing,f3_l-d_kp_4_20,1,4,28,35,7,24011,34
Simulated Annealing,f4_l-d_kp_4_11,1,4,23,23,0,24008,30
Simulated Annealing,f6_l-d_kp_10_60,1,10,36,52,16,60012,39
Simulated Annealing,f7_l-d_kp_7_50,1,7,114,107,-7,42007,28
Simulated Annealing,f8_l-d_kp_23_10000,1,23,10567,9767,-800,138025,61
Simulated Annealing,f9_l-d_kp_5_80,1,5,142,130,-12,30013,29
Simulated Annealing,f10_l-d_kp_20_879,1,20,833,1025,192,120084,66
Simulated Annealing,f1_l-d_kp_10_269,1,10,201,295,94,60012,38
Simulated Annealing,f2_l-d_kp_20_878,1,20,820,1024,204,120039,71
Simulated Annealing,f3_l-d_kp_4_20,1,4,28,35,7,24010,27
Simulated Annealing,f4_l-d_kp_4_11,1,4,29,23,-6,24007,25
Simulated Annealing,f6_l-d_kp_10_60,1,10,62,52,-10,60012,49
Simulated Annealing,f7_l-d_kp_7_50,1,7,96,107,11,42007,30
Simulated Annealing,f8_l-d_kp_23_10000,1,23,9724,9767,43,138026,58
Simulated Annealing,f9_l-d_kp_5_80,1,5,109,130,21,30005,34
Simulated Annealing,f10_l-d_kp_20_879,1,20,911,1025,114,120075,64
Simulated Annealing,f1_l-d_kp_10_269,1,10,261,295,34,60015,34
Simulated Annealing,f2_l-d_kp_20_878,1,20,930,1024,94,120079,62
Simulated Annealing,f3_l-d_kp_4_20,1,4,37,35,-2,24009,25
Simulated Annealing,f4_l-d_kp_4_11,1,4,28,23,-5,24004,25
Simulated Annealing,f6_l-d_kp_10_60,1,10,31,52,21,60010,47
Simulated Annealing,f7_l-d_kp_7_50,1,7,59,107,48,42007,27
Simulated Annealing,f8_l-d_kp_23_10000,1,23,9578,9767,189,138023,76
Simulated Annealing,f9_l-d_kp_5_80,1,5,142,130,-12,30010,29
Simulated Annealing,f10_l-d_kp_20_879,1,20,1002,1025,23,120106,65
Simulated Annealing,f1_l-d_kp_10_269,1,10,189,295,106,60010,41
Simulated Annealing,f2_l-d_kp_20_878,1,20,721,1024,303,120020,57
Simulated Annealing,f3_l-d_kp_4_20,1,4,37,35,-2,24011,25
Simulated Annealing,f4_l-d_kp_4_11,1,4,28,23,-5,24004,25
Simulated Annealing,f6_l-d_kp_10_60,1,10,40,52,12,60011,35
Simulated Annealing,f7_l-d_kp_7_50,1,7,117,107,-10,42007,27
Simulated Annealing,f8_l-d_kp_23_10000,1,23,10668,9767,-901,138026,61
Simulated Annealing,f9_l-d_kp_5_80,1,5,142,130,-12,30006,39
Simulated Annealing,f10_l-d_kp_20_879,1,20,888,1025,137,120046,62
Simulated Annealing,f1_l-d_kp_10_269,1,10,296,295,-1,60023,33
Simulated Annealing,f2_l-d_kp_20_878,1,20,857,1024,167,120083,64
Simulated Annealing,f3_l-d_kp_4_20,1,4,28,35,7,24011,25
Simulated Annealing,f4_l-d_kp_4_11,1,4,29,23,-6,24004,26
Simulated Annealing,f6_l-d_kp_10_60,1,10,56,52,-4,60010,33
Simulated Annealing,f7_l-d_kp_7_50,1,7,69,107,38,42010,28
Simulated Annealing,f8_l-d_kp_23_10000,1,23,9731,9767,36,138042,73
Simulated Annealing,f9_l-d_kp_5_80,1,5,109,130,21,30014,29
Simulated Annealing,f10_l-d_kp_20_879,1,20,911,1025,114,120086,65
Simulated Annealing,f1_l-d_kp_10_269,1,10,242,295,53,60010,40
Simulated Annealing,f2_l-d_kp_20_878,1,20,828,1024,196,120078,64
Simulated Annealing,f3_l-d_kp_4_20,1,4,37,35,-2,24010,28
Simulated Annealing,f4_l-d_kp_4_11,1,4,22,23,1,24007,26
Simulated Annealing,f6_l-d_kp_10_60,1,10,62,52,-10,60010,34
Simulated Annealing,f7_l-d_kp_7_50,1,7,59,107,48,42009,29
Simulated Annealing,f8_l-d_kp_23_10000,1,23,9073,9767,694,138027,57
Simulated Annealing,f9_l-d_kp_5_80,1,5,142,130,-12,30014,33
